{
  "widht": 10,
  "height": 5,
  "tiles": [
    [ 0, 0, 0, 0, 0, 0, 0, 0, 0, 0 ],
    [ 0, 0, 0, 0, 0, 0, 0, 0, 0, 0 ],
    [ 0, 0, 1, 1, 1, 1, 0, 0, 0, 0 ],
    [ 0, 0, 0, 0, 0, 0, 0, 0, 0, 0 ],
    [ 1, 1, 1, 1, 1, 1, 1, 1, 1, 1 ]
  ]
}